




F 225,130,1



C 225,130,0


         NO ./textures/texture_nord.png
SO ./textures/texture_sud.png
WE ./textures/texture_ouest.png
EA ./textures/texture_est.png


        1111111111111111111111111
        1000000000110000000000001
        1011000000000000000000001
        100100000000000000N000001
111111111011000000000000000000001
100000000011000001110111111111111
11110111111111011100000010001
11110111111111011101010010001
11000000110101011100000010001
10000000000000001100000010001
10000000000000001101010010001
11000001110101011111011110001
11110111 1110101 101111010001
11111111 1111111 111111111111